22 22 22 22 22 22 22 23 45 28 28 28 28 28 79 79 79 79 79 79 79 79 79 79 79 79 79 79 79 79 79 79 79 79 4 4 4 4 4 21 22 22 22 22 22 22 22 22 23 79 79 79 79 79 79 79 79 79 79 79 79 79 79 79 79 79 79 79 79 79 79 79 79 79 79 79 79 79 79 79 
22 22 22 22 22 22 22 23 45 28 29 29 29 28 79 79 79 79 79 79 79 79 79 79 79 79 79 79 79 79 79 79 79 79 4 27 27 27 45 21 22 22 22 22 22 22 22 22 23 79 79 79 79 79 79 79 79 79 79 79 79 79 79 79 79 79 79 79 79 79 79 79 79 79 79 79 79 79 79 79 
22 22 22 22 22 22 22 23 45 28 29 29 29 28 79 79 79 79 79 79 79 79 79 79 79 79 79 79 79 79 79 79 79 79 4 27 27 27 45 21 22 22 22 22 22 22 22 22 23 79 79 79 79 79 79 79 79 79 79 79 79 79 79 79 79 79 79 79 79 79 79 79 79 79 79 79 79 79 79 79 
22 22 22 22 22 22 22 23 45 28 29 29 29 28 79 79 79 79 79 79 79 79 79 79 79 79 79 79 79 79 79 79 79 79 4 27 27 27 45 21 22 22 22 22 22 22 22 22 23 79 79 79 79 79 79 79 79 79 79 79 79 79 79 79 79 79 79 79 79 79 79 79 79 79 79 79 79 79 79 79 
22 22 22 22 22 22 22 23 45 28 28 28 28 28 79 79 79 79 79 79 79 79 79 79 79 79 79 79 79 79 79 79 18 45 45 45 45 45 45 21 22 22 22 22 22 22 22 22 23 79 79 79 79 79 79 79 79 79 79 79 79 79 79 79 79 79 79 79 79 79 79 79 79 79 79 79 79 79 79 79 
22 22 22 22 22 22 22 23 45 45 45 45 45 45 18 79 79 79 79 79 79 79 79 79 79 79 79 79 79 79 79 79 45 11 12 12 12 12 12 25 22 22 22 22 22 22 22 22 23 79 79 79 79 79 79 79 79 79 79 79 79 79 79 79 79 79 79 79 79 79 79 79 79 79 79 79 79 79 79 79 
22 22 22 22 22 22 22 24 12 12 12 12 12 13 45 79 79 79 79 79 79 79 79 79 79 79 79 79 79 79 79 79 45 21 22 22 22 22 22 22 22 22 22 22 22 22 22 22 23 79 79 79 79 79 79 79 79 79 79 79 79 79 79 79 79 79 79 79 79 79 79 79 79 79 79 79 79 79 79 79 
22 22 22 22 22 22 22 22 22 22 22 22 22 23 45 79 79 79 79 79 79 79 79 79 79 79 79 79 79 79 79 45 45 21 22 22 22 22 22 22 22 22 22 22 22 22 22 22 23 79 79 79 79 79 79 79 79 79 79 79 79 79 79 79 79 79 79 79 79 79 79 79 79 79 79 79 79 79 79 79 
22 22 22 22 22 22 22 22 22 22 22 22 22 23 45 79 79 79 79 79 79 79 79 79 79 79 79 18 45 45 45 45 45 21 22 22 22 22 22 22 22 22 22 22 22 22 22 22 23 79 79 79 79 79 79 79 79 79 79 79 79 79 79 79 79 79 79 79 79 79 79 79 79 79 79 79 79 79 79 79 
22 22 22 22 22 22 22 22 22 22 22 22 22 23 45 79 79 79 79 79 79 79 79 79 79 79 79 45 11 12 12 12 12 25 22 22 22 22 22 22 22 22 22 22 22 22 22 22 23 79 79 79 79 79 79 79 79 79 79 79 79 79 79 79 79 79 79 79 79 79 79 79 79 79 79 79 79 79 79 79 
22 22 22 22 22 22 22 22 22 22 22 22 22 23 45 79 79 79 79 79 79 79 79 79 79 79 79 45 21 22 22 22 22 22 22 22 22 22 22 22 22 22 22 22 22 22 22 22 23 79 79 79 79 79 79 79 79 79 79 79 79 79 79 79 79 79 79 79 79 79 79 79 79 79 79 79 79 79 79 79 
22 22 22 22 22 22 22 22 22 22 22 22 22 23 45 45 45 45 45 45 45 45 45 45 45 45 45 45 21 22 22 22 22 22 22 22 22 22 22 22 22 22 22 22 22 22 22 22 23 79 79 79 79 79 79 79 79 79 79 79 79 79 79 79 79 79 79 79 79 79 79 79 79 79 79 79 79 79 79 79 
22 22 22 22 22 22 22 22 22 22 22 22 22 24 12 12 12 12 12 12 12 12 12 12 12 12 12 12 25 22 22 22 22 22 22 22 22 22 22 22 22 22 22 22 22 22 22 22 23 79 79 79 79 79 79 79 79 79 79 79 79 79 79 79 79 79 79 79 79 79 79 79 79 79 79 79 79 79 79 79 
22 22 22 22 22 22 22 22 22 22 22 22 22 22 22 22 22 22 22 22 22 22 22 22 22 22 22 22 22 22 22 22 22 22 22 22 22 22 22 22 22 22 22 22 22 22 22 22 23 79 79 79 79 79 79 79 79 79 79 79 79 79 79 79 79 79 79 79 79 79 79 79 79 79 79 79 79 79 79 79 
22 22 22 22 22 22 22 22 22 22 22 22 22 22 22 22 22 22 22 22 22 22 22 22 22 22 22 22 22 22 22 22 22 22 22 22 22 22 22 22 22 22 22 22 22 22 22 22 23 79 79 79 79 79 79 79 79 79 79 79 79 79 79 79 79 79 79 79 79 79 79 79 79 79 79 79 79 79 79 79 
22 22 22 22 22 22 22 22 22 22 22 22 22 22 22 22 22 22 22 22 22 22 22 22 22 22 22 22 22 22 22 22 22 22 22 22 22 22 22 22 22 22 22 22 22 22 22 22 24 12 12 12 13 79 79 79 79 79 79 79 79 79 79 79 79 79 79 79 79 79 79 79 79 79 79 79 79 79 79 79 
22 22 22 22 22 22 22 22 22 22 22 22 22 22 22 22 22 22 22 22 22 22 22 22 22 22 22 22 22 22 22 22 22 22 22 22 22 22 22 22 22 22 22 22 22 22 22 22 22 22 22 22 23 79 79 79 79 79 79 79 79 79 79 79 79 79 79 79 79 79 79 79 79 79 79 79 79 79 79 79 
22 22 22 22 22 22 22 22 22 22 22 22 22 22 22 22 22 22 22 22 22 22 22 22 22 22 22 22 22 22 22 22 22 22 22 22 22 22 22 22 22 22 22 22 22 22 22 22 22 22 22 22 23 79 79 79 79 79 79 79 79 79 79 79 79 79 79 79 79 79 79 79 79 79 79 79 79 79 79 79 
22 22 22 22 22 22 22 22 22 22 22 22 22 22 22 22 22 22 22 22 22 22 22 22 22 22 22 22 22 22 22 22 22 22 22 22 22 22 22 22 22 22 22 22 22 22 22 22 22 22 22 22 23 79 79 79 79 79 79 79 79 79 79 79 79 79 79 79 79 79 79 79 79 79 79 79 79 79 79 79 
22 22 22 22 22 22 22 22 22 22 22 22 22 22 22 22 22 22 22 22 22 22 22 22 22 22 22 22 22 22 22 22 22 22 22 22 22 22 22 22 22 22 22 22 22 22 22 22 22 22 22 22 23 79 79 79 79 79 79 79 79 79 79 79 79 79 79 79 79 79 79 79 79 79 79 79 79 79 79 79 
22 22 22 22 22 22 22 22 22 22 22 22 22 22 22 22 22 22 22 22 22 22 22 22 22 22 22 22 22 22 22 22 22 22 22 22 22 22 22 22 22 22 22 22 22 22 22 22 22 22 22 22 23 79 79 79 79 79 79 139 139 139 139 139 139 139 139 139 139 139 139 139 139 139 139 79 79 79 79 79 
22 22 22 22 22 22 22 22 22 22 22 22 22 22 22 22 22 22 22 22 22 22 22 22 22 22 22 22 22 22 22 22 22 22 22 22 22 22 22 22 22 22 22 22 22 22 22 22 22 22 22 22 23 79 79 79 79 79 79 139 139 139 139 139 139 139 139 139 139 139 139 139 139 139 139 79 79 79 79 79 
32 32 32 32 32 32 32 32 32 32 32 32 32 32 32 32 15 22 22 22 22 22 22 22 22 22 22 22 22 22 22 22 22 22 22 22 22 22 22 22 22 22 22 22 22 22 22 22 22 22 22 22 23 79 79 79 79 79 79 139 139 139 139 139 139 139 139 139 139 139 139 139 139 139 139 79 79 79 79 79 
79 79 79 79 79 79 79 79 79 79 79 79 79 79 79 79 21 22 22 22 22 22 22 22 22 22 22 22 22 22 22 22 22 22 22 22 22 22 22 22 22 22 22 22 22 22 22 22 22 22 22 22 24 12 12 12 12 13 79 139 139 139 139 139 139 147 147 147 147 147 147 139 139 139 139 79 79 79 79 79 
79 79 79 79 79 79 79 79 79 79 79 79 79 79 79 79 31 32 15 22 22 22 22 22 22 22 22 22 22 22 22 22 22 22 22 22 22 22 22 22 22 22 22 22 22 22 22 22 22 22 22 22 22 22 22 22 22 23 79 139 139 139 139 139 139 157 157 157 157 157 157 139 139 139 139 79 79 79 79 79 
79 79 79 79 79 79 79 79 79 79 79 79 79 79 79 79 7 8 31 15 22 22 22 22 22 22 22 22 22 22 22 22 22 22 22 22 22 22 22 22 22 22 22 22 22 22 22 22 22 22 22 22 22 22 22 22 22 23 79 79 6 79 139 139 139 157 157 157 157 157 157 192 192 183 194 79 79 79 79 79 
79 79 79 79 79 79 79 79 79 79 79 79 79 79 79 79 6 7 9 21 22 22 22 22 22 22 22 22 22 22 22 22 22 22 22 22 22 22 22 22 22 22 22 22 22 22 22 22 22 22 22 22 22 22 22 22 22 23 79 6 79 79 139 139 139 167 167 167 167 167 167 192 79 79 79 79 79 79 79 79 
79 79 79 79 79 79 79 79 79 79 79 79 79 79 79 79 7 8 7 31 32 32 32 32 15 22 22 22 22 22 22 22 22 22 22 22 22 22 22 22 22 22 22 22 22 22 22 22 22 22 22 22 22 22 22 22 22 23 79 26 79 44 79 139 139 139 139 139 139 139 139 139 79 79 79 79 79 79 79 79 
79 79 79 79 79 79 79 79 79 79 79 79 79 79 79 79 79 79 79 79 79 79 79 79 21 22 22 22 22 22 22 22 22 22 22 22 22 22 22 22 22 22 22 22 22 22 22 22 22 22 22 22 22 22 22 22 22 23 79 79 79 79 44 79 79 79 79 79 79 79 79 79 79 79 79 79 79 79 79 79 
79 79 79 79 79 79 79 79 79 79 79 79 79 79 79 79 79 79 79 79 79 79 79 79 21 22 22 22 22 22 22 22 22 22 22 22 22 22 22 22 22 22 22 22 22 22 22 22 22 22 22 22 22 22 22 22 22 24 12 12 12 12 12 12 12 12 12 12 12 13 79 79 79 79 17 79 79 79 79 79 
79 79 79 79 79 79 79 79 79 79 79 79 79 79 79 79 79 79 79 79 79 79 79 79 21 22 22 22 22 22 22 22 22 22 22 22 22 22 22 22 22 22 22 22 22 22 22 22 22 22 22 22 22 22 22 22 22 22 22 22 22 22 22 22 22 22 22 22 22 23 79 79 17 79 79 79 79 79 79 79 
79 79 79 79 79 79 79 79 79 79 79 79 79 79 79 79 79 79 79 79 79 79 79 79 21 22 22 22 22 22 22 22 22 22 22 22 22 22 22 22 22 22 22 22 22 22 22 22 22 22 22 22 22 22 22 22 22 22 22 22 22 22 22 22 22 22 22 22 22 23 79 79 79 44 79 79 17 79 79 79 
79 79 79 79 79 79 79 79 79 79 79 79 79 79 79 79 79 79 79 79 79 79 79 79 21 22 22 22 22 22 22 22 22 22 22 22 22 22 22 22 22 22 22 22 22 22 22 22 22 22 22 22 22 22 22 22 22 22 22 22 22 22 22 22 22 22 22 22 22 23 79 79 79 79 79 79 79 79 79 79 
79 79 79 79 79 79 79 79 79 79 79 79 79 79 79 79 79 79 79 79 79 79 79 79 21 22 22 22 22 22 22 22 22 22 22 22 22 22 22 22 22 22 22 22 22 22 22 22 22 22 22 22 22 22 22 22 22 22 22 22 22 22 22 22 22 22 22 22 22 24 12 12 12 12 12 12 12 12 12 12 
79 79 79 79 79 79 79 79 79 79 79 79 79 79 79 79 79 79 79 79 79 79 79 79 21 22 22 22 22 22 22 22 22 22 22 22 22 22 22 22 22 22 22 14 32 32 32 32 32 32 32 32 32 32 32 32 15 22 22 22 22 22 22 22 22 22 22 22 22 22 22 22 22 22 22 22 22 22 22 22 
79 79 79 79 79 79 79 79 79 79 79 79 79 79 79 79 79 79 79 79 79 79 79 79 21 22 22 22 22 22 22 22 22 22 22 22 22 22 22 22 22 22 22 23 79 79 79 79 79 79 79 79 79 79 79 79 21 22 22 22 22 22 22 22 22 22 22 22 22 22 22 22 22 22 22 22 22 22 22 22 
79 79 79 79 79 79 79 79 79 79 79 79 79 79 79 79 6 7 8 6 7 9 8 9 21 22 22 22 22 22 22 22 22 22 22 22 22 22 22 22 22 22 22 23 79 79 79 79 79 79 79 79 79 79 79 79 21 22 22 22 22 22 22 22 22 22 22 22 22 22 22 22 22 22 22 22 22 22 22 22 
79 79 79 79 79 79 79 79 79 79 79 79 79 79 79 7 11 12 12 12 12 12 12 12 25 22 22 22 22 22 22 22 22 14 32 32 32 32 32 32 32 32 32 33 79 79 79 79 79 79 79 79 79 79 79 79 21 22 22 22 22 22 22 22 22 22 22 22 22 22 22 22 22 22 22 22 22 22 22 22 
79 79 79 79 79 79 79 79 79 79 37 38 39 36 79 6 21 22 22 22 22 22 22 22 22 22 22 22 22 22 22 22 22 23 79 79 79 79 79 79 79 79 79 79 79 79 79 79 79 79 79 79 79 79 79 79 21 22 22 22 22 22 22 22 22 22 22 22 22 22 22 22 22 22 22 22 22 22 22 22 
16 17 16 16 17 16 16 17 16 79 47 48 49 46 79 8 21 22 22 22 22 22 22 22 22 22 22 22 22 22 22 22 22 23 79 79 79 79 79 79 79 79 79 79 79 79 79 79 79 79 79 79 79 79 79 79 21 22 22 22 22 22 22 22 22 22 22 22 22 22 22 22 22 22 22 22 22 22 22 22 
66 67 68 68 68 68 68 68 69 79 57 58 59 56 79 7 21 22 22 22 22 22 22 22 22 22 22 22 22 22 22 22 22 23 79 79 79 108 108 108 108 108 108 108 108 108 108 108 108 108 108 108 108 108 108 79 31 32 32 32 32 15 22 22 22 22 22 22 22 22 22 22 22 22 22 22 22 22 22 22 
12 12 12 12 12 12 12 12 12 12 12 12 12 12 12 12 25 22 22 22 22 22 22 22 22 22 22 22 22 22 22 22 22 23 79 79 79 108 108 108 108 108 108 108 108 108 108 108 108 108 108 108 108 108 108 79 79 79 79 79 79 21 22 22 22 22 22 22 22 22 22 22 22 22 22 22 22 22 22 22 
22 22 22 22 22 22 22 22 22 22 22 22 22 22 22 22 22 22 22 22 22 22 22 22 22 22 22 22 22 22 22 22 22 23 79 79 79 108 108 108 108 108 108 108 108 108 108 108 108 108 108 108 108 108 108 79 79 79 79 79 79 21 22 22 22 22 22 22 22 22 22 22 22 22 22 22 22 22 22 22 
22 22 22 22 22 22 22 22 22 22 22 22 22 22 22 22 22 22 22 22 22 22 22 22 22 22 22 22 22 22 22 22 22 23 79 79 79 108 108 108 108 108 108 108 108 108 108 108 108 108 108 108 108 108 108 79 79 79 79 79 79 21 22 22 22 22 22 22 22 22 22 22 22 22 22 22 22 22 22 22 
22 22 22 22 22 22 22 22 22 22 22 22 22 22 22 22 22 22 22 22 22 22 22 22 22 22 22 22 22 22 22 22 22 23 79 79 79 108 108 108 108 108 108 108 108 108 108 108 108 108 108 108 108 108 108 79 79 79 79 79 79 21 22 22 22 22 22 22 22 22 22 22 22 22 22 22 22 22 22 22 
22 22 22 22 22 22 22 22 22 22 22 22 22 22 22 22 22 22 22 22 22 22 22 22 22 22 22 22 22 22 22 22 22 23 79 79 79 108 108 108 108 108 108 108 108 108 108 108 108 108 108 108 108 108 108 79 79 79 79 79 79 21 22 22 22 22 22 22 22 22 22 22 22 22 22 22 22 22 22 22 
22 22 22 22 22 22 22 22 22 22 22 22 22 22 22 22 22 22 22 22 22 22 22 22 22 22 22 22 22 14 32 32 32 33 79 79 79 108 108 108 108 108 108 108 108 108 108 108 108 108 108 108 108 108 108 79 79 79 79 79 79 31 32 32 32 32 32 32 32 32 32 32 15 22 22 22 22 22 22 22 
22 22 22 22 22 22 22 22 22 22 22 22 22 22 22 22 22 22 22 22 22 22 22 22 22 22 22 22 22 23 79 79 79 79 79 79 79 108 108 108 108 108 108 108 108 108 108 108 108 108 108 108 108 108 108 79 79 79 79 79 79 79 79 79 79 79 79 79 79 79 79 79 21 22 22 22 22 22 22 22 
22 22 22 22 22 22 22 22 22 22 22 22 22 22 22 22 22 22 22 22 22 22 22 22 22 22 22 22 22 23 79 79 79 79 79 79 79 108 108 108 108 108 108 108 108 108 108 108 108 108 108 108 108 108 108 79 79 79 79 79 79 79 79 79 79 79 79 79 79 79 79 79 21 22 22 22 22 22 22 22 
22 22 22 22 22 22 22 22 22 22 22 22 22 22 22 22 22 22 22 22 22 22 22 22 22 22 22 22 22 23 79 79 79 79 79 79 79 79 79 79 79 79 79 79 79 79 79 79 79 79 79 79 79 79 79 79 79 79 79 79 79 79 79 79 79 79 79 79 79 79 79 79 21 22 22 22 22 22 22 22 

